11111111111111111111111111111111111111111111111111111
10000000000000000000000000000000000000000000000000001
100000000C0000000000000000000000000000000000000C00001
10000000000000000000000000000000000000000000000000001
10000000000000000000000000000000000000000000000000001
10000000000000000000000000000000000000000000000000001
10000000000000000000000000000000000000000000000000001
10000000000000000000000000000000000000000000000C00001
100000000C0000000000000000000000000000000000000000001
10000000000000000000000000000000000000000000000000001
1000000000000000000000P000000000000000000000000000001
1000000000000000000000C000000000000000000000000000001
10000000000000000000000000000000000000000000000C00001
10000000000000000000000000000000000000000000000000001
10000000000000000000000000000000000000000111111111111
10011000000000000000000000000000000000001000E00000001
101000100000000C0000000000000000000000010000000000001
1C1C0010000000000000000000000000000000010000000000001
11111111111111111111111111111111111111111111111111111
